WWWWWWWWWWWWWWWWWW
WWWWWWWWWVWWWWWWWW
WWWVW       WWWWWW
WVWWW   P  WWWVWWW
WWWW       WWWWWWW
WWWWWW   WWWWWWWWW
WWWWWWWWWWWWWWWWWW
WWWVWWWWWWWWWVWWWW
WWWWWWWWWWWWWWWWWW
