XXXXXXXXXXXXXXXXXXXXXXXXXXXXXXXXXXXX
X                                  X
X  P                               X
X                                  X
X                                  X
X                                  X
X                                  X
X                                  X
X                                  X
X                                  X
X                                  X
X                                  X
X                                  X
X                                  X
X                                  X
X                                  X
X                                  X
X                                  X
X                                  X
X                                  X
X                                  X
X                                  X
X                                  X
X                                  X
X                                  X
X                                  X
X                                  X
X                                  X
X                                  X
X                                  X
X                                  X
X                                  X
X                                  X
X                                  X
X                                  X
X                                  X
X                                  X
X                                  X
X                                  X
X                                  X
X                                  X
X                                  X
XXXXXXXXXXXXXXXXXXXXXXXXXXXXXXXXXXXX